000000
111111
222222
333333
444444
555555
666666
777777
888888