11111111
100000E1
10111001
10101001
101P1111
10101001
100010C1
11111111