11111111
101010E1
11111001
10101001
101P1011
10101001
100000C1
11111111