11111111
10000C01
1P011001
10000E01
11111111