11111111
101010E1
11111001
10101001
101P1011
101C1001
1C0000C1
11111111